BBBBBBBBBBBBBBBBBBBBBBBBBBBBBBBBBBBBBBBBBBBBBBBBBBBBBBBBBBBBBBBB
B11111111111111111111111111111111111111111111111111111122222222B
B111111111111111111111111111111111BBBBB111111111111111122222222B
B1LBBBBB22BBBBBB222BBBB3333BBB1111BBBBB11111BB11111111122222222B
B1BBBBBB22BBBBBB222BBBB3333BBB1111BBBBB11111BB22222BBBB22222222B
B1BBBBBB22BBBBBB222BBBB3333BBB1111BBBBB11111BB22222BBBB22222222B
B1BBBBBB22111111222BBBB3333BBB1111BBBBB11111BB22222111122222222B
B11111111111111122211113333BBB111111111111111122222111122222222B
B11111111111111111111111111111111111111111111122222111122222222B
B1111111111111112221111333311111111111113333BB22222111122222222B
B1111111111111112221BB13333BBB11111111113333BB22222111122222222B
B11BBB22221BBB111111BB13333BBB11111111113333BB22222111122222222B
B11BBB22221BBB111111BB13333BBB1111BBBBBB3333NB222221BB122222222B
B11BBB22221BBB111111BB13333BBB1111BBBBBB3333BB222221BB122BBCBB2B
B11BBB22221111111111BB13333BBB11111111113333BB11111111122BBBBB2B
B1111122221111111111111111111111111111113333BB11111111122BBBBB2B
B11111222211111111111111111111111111111133331111111111122BBBBB2B
B11111222211111111BBBBBB11111133333BBB1133331111111111122BBBBB2B
B11111222211111111BBBBBB11111133333BBB1133331111111111122222222B
B11111222211111111BBBBBB1111BB33333BBB11111BBB11111BBBB22222222B
B11BBB2222BBBBBB11BBBBBB1111BB33333BBB11111BBB11111BBBB22222222B
B11BBB2222BBBBBB11BBBBBB1111BB33333BBB11111BBB11111BBBB22222222B
B11111111111111111BBBBBB11111133333BBB11111BBB11111BBBB22222222B
B11111111111111111BBBBBB11111133333BBB1111111111111111122222222B
B11111111111111111111111111111111111111111111111111111122222222B
B11111111111111111111111111111111111111111111111111111122222222B
B22PBB22221111122211111122BBBBB333BBBBBB333BBBB3333111122222222B
B22BBB2222BBBBB22211111122BBBBB333BBBBBB333BBBB3333BBB122222222B
B22BBB2222BBBBB222BBBBBB22BBBBB333BBBBBB333BBBB3333BBB122222222B
B22BBB2222BBBBB222BBBBBB22BBBBB333BBBBBB333BBBB3333BBB122222222B
B22BBB22221111122211111122BBBBB333BBBBBB333BBBB3333BBB122222222B
B2211122221111122211111122BBBBB333111111333BBBB3333111122222222B
B11111111111111111111111111111111111111111111111111111122222222B
B11111111111111111111111111111111111111111111111111111122222222B
B11111111111111111111111111111111111111111111111111111122222222B
BBBBBBBBBBBBBBBBBBBBBBBBBBBBBBBBBBBBBBBBBBBBBBBBBBBBBBBBBBBBBBBB

